{
    "level_id": "level_8_claustrophobia",
    "width": 20,
    "height": 20,
    "legend": {
        "#": "Wall",
        ".": "Floor",
        "S": "Start",
        "E": "Entity",
        "K": "Key",
        "D": "Debris",
        "O": "Pillar",
        "L": "Locked Door",
        "X": "Exit"
    },
    "layout": [
        "####################",
        "#################..#",
        "#################..#",
        "##############..#.E#",
        "##############.O...#",
        "#############......#",
        "########XL.#..O..DK#",
        "#########O.........#",
        "########..E...O...##",
        "#########.O.O......#",
        "########...........#",
        "######.#.........SD#",
        "######......D...O..#",
        "######....O.O...O..#",
        "#######..O...OO....#",
        "########...D......O#",
        "#########........O.#",
        "#########..........#",
        "#########D.E......##",
        "####################"
    ]
}