{
    "level_id": "level_10_echo_chamber",
    "width": 30,
    "height": 30,
    "legend": {
        "#": "Wall",
        ".": "Floor",
        "S": "Start",
        "E": "Entity",
        "K": "Key",
        "D": "Debris",
        "O": "Pillar",
        "L": "Locked Door",
        "X": "Exit"
    },
    "layout": [
        "##############################",
        "#D.###..######################",
        "#.D.#...###############X######",
        "#...D..###########....#L.#####",
        "#..#....######.D##.......#####",
        "#.......O.......#..D.....#####",
        "#..#...###.........###########",
        "#....#####E........###########",
        "#...####......D......#########",
        "#D......DO.OD..DED..##########",
        "##DD....#..........###########",
        "####.......DD#################",
        "###.EO....D..#################",
        "###.........OD################",
        "####......D..######.##########",
        "####.........##......#########",
        "#####........###...O##########",
        "#####O.....#..##.#.###########",
        "#####..O.......#O..###########",
        "#######...####.O.#..##########",
        "#######S....##...##.D.########",
        "########..D....####...########",
        "########D..##.###......#######",
        "#######........E...O..########",
        "###................#..########",
        "###...O...K..O.D..############",
        "#....O........##..############",
        "#O.......D....###D############",
        "#..D....E.......##############",
        "##############################"
    ]
}