{
    "level_id": "level_3_the_corridor",
    "width": 20,
    "height": 12,
    "legend": {
        "#": "Wall",
        ".": "Floor",
        "S": "Start",
        "E": "Entity",
        "K": "Key",
        "D": "Debris",
        "O": "Pillar",
        "L": "Locked Door",
        "X": "Exit"
    },
    "layout": [
        "####################",
        "#.....S..........###",
        "#........D..O....###",
        "#O................##",
        "#.........##.....D##",
        "#...##.##..#.DE...##",
        "#.#######..#....OO.#",
        "##########.KD##...L#",
        "###############.D#X#",
        "####################",
        "####################",
        "####################"
    ]
}