{
    "level_id": "level_1_atrium",
    "width": 20,
    "height": 12,
    "legend": {
        "#": "Wall",
        ".": "Floor",
        "S": "Start",
        "E": "Entity",
        "K": "Key",
        "D": "Debris",
        "O": "Pillar",
        "L": "Locked Door",
        "X": "Exit"
    },
    "layout": [
        "####################",
        "#S.................#",
        "#######..###########",
        "#.......O..........#",
        "#..O.........O.....#",
        "#.......E..........#",
        "#..O.........O.....#",
        "#######..###########",
        "#DDDDD....K........#",
        "#######L############",
        "#..................#",
        "##################X#"
    ]
}