{
    "level_id": "level_5_debris_field",
    "width": 20,
    "height": 15,
    "legend": {
        "#": "Wall",
        ".": "Floor",
        "S": "Start",
        "E": "Entity",
        "K": "Key",
        "D": "Debris",
        "O": "Pillar",
        "L": "Locked Door",
        "X": "Exit"
    },
    "layout": [
        "####################",
        "#.E.....O.##########",
        "#.DDDD....##########",
        "#.....D..###########",
        "#....DDO.###########",
        "#....#D..###########",
        "#.........S#########",
        "##..D....D.#########",
        "###.##..O..#########",
        "##....D....#########",
        "##....D....#########",
        "#.......D....#######",
        "##....DE.K.#D.######",
        "#XL...........######",
        "####################"
    ]
}