{
    "level_id": "level_4_shadows",
    "width": 20,
    "height": 15,
    "legend": {
        "#": "Wall",
        ".": "Floor",
        "S": "Start",
        "E": "Entity",
        "K": "Key",
        "D": "Debris",
        "O": "Pillar",
        "L": "Locked Door",
        "X": "Exit"
    },
    "layout": [
        "####################",
        "##########XLE.######",
        "###########....#####",
        "###########......###",
        "#########.##..##..##",
        "########......#...##",
        "########O#.#...O...#",
        "########......D....#",
        "########D...D......#",
        "########E..O.......#",
        "#####..O...D.......#",
        "#####..##.......S..#",
        "######..K..O.......#",
        "######....D.#...#..#",
        "####################"
    ]
}