{
    "level_id": "level_9_the_gauntlet",
    "width": 30,
    "height": 25,
    "legend": {
        "#": "Wall",
        ".": "Floor",
        "S": "Start",
        "E": "Entity",
        "K": "Key",
        "D": "Debris",
        "O": "Pillar",
        "L": "Locked Door",
        "X": "Exit"
    },
    "layout": [
        "##############################",
        "#XL......#####################",
        "##D..###..E###################",
        "##..######O.##################",
        "#....###...###################",
        "#D...#.....###################",
        "#........#.###################",
        "#..OD......###################",
        "#...#....D.####.D.####.#######",
        "#.D.O....D.####.D.D....#######",
        "#.........O.###D.D...#########",
        "#..##...#...##D...############",
        "#.D.....##D.O.D......#########",
        "#O...E.....O.#.#....O#########",
        "#D......D...........D#########",
        "#............D...S..##########",
        "#..................###########",
        "#...O...........#....#########",
        "##..............##....########",
        "###.............##..##########",
        "####...K....E..###############",
        "####..E#..O.#..D##############",
        "###....##........#############",
        "####...###......##############",
        "##############################"
    ]
}