{
    "level_id": "level_6_the_maze",
    "width": 25,
    "height": 20,
    "legend": {
        "#": "Wall",
        ".": "Floor",
        "S": "Start",
        "E": "Entity",
        "K": "Key",
        "D": "Debris",
        "O": "Pillar",
        "L": "Locked Door",
        "X": "Exit"
    },
    "layout": [
        "#########################",
        "##...O.......O.##########",
        "###.........D..O#########",
        "##....K...D.O....########",
        "#.....E.........#########",
        "#...#O....O.....S....####",
        "#..........###.D..#..####",
        "#.........####......#####",
        "#........D.#.......######",
        "#..O......D....D.D.######",
        "##.#.........############",
        "####..#E..###############",
        "#####.....###############",
        "######....####D##########",
        "#####...#####...#########",
        "#####.######.D...########",
        "#####L..####.....########",
        "#####X#.O#.#..###########",
        "######.......D###########",
        "#########################"
    ]
}