{
    "level_id": "level_7_surrounded",
    "width": 25,
    "height": 20,
    "legend": {
        "#": "Wall",
        ".": "Floor",
        "S": "Start",
        "E": "Entity",
        "K": "Key",
        "D": "Debris",
        "O": "Pillar",
        "L": "Locked Door",
        "X": "Exit"
    },
    "layout": [
        "#########################",
        "#.......#################",
        "#.D....S#################",
        "#..D...O.#..D############",
        "#....#.O.....############",
        "#....#.......############",
        "#.....D.O.......#####D###",
        "##.....O....EO....O.....#",
        "##O..D..............#...#",
        "###..........#..E..####.#",
        "#####.#..D....##..K.....#",
        "#####......#...#.########",
        "#####.......##.D.########",
        "#####....O..##.D#########",
        "####..D......############",
        "#######...E.#############",
        "#######....##############",
        "######.O..O.#############",
        "#####.......LX###########",
        "#########################"
    ]
}