{
    "level_id": "test_arena_empty",
    "width": 20,
    "height": 20,
    "legend": {
        "#": "Wall",
        ".": "Floor",
        "S": "Start",
        "E": "Entity",
        "K": "Key",
        "D": "Debris",
        "O": "Pillar",
        "L": "Locked Door",
        "X": "Exit"
    },
    "layout": [
        "####################",
        "#..................#",
        "#..................#",
        "#..................#",
        "#..................#",
        "#..................#",
        "#..................#",
        "#..................#",
        "#..................#",
        "#.........S........#",
        "#..................#",
        "#..................#",
        "#..................#",
        "#..................#",
        "#.......E..........#",
        "#..................#",
        "#..................#",
        "#..................#",
        "#..................#",
        "####################"
    ]
}