{
    "level_id": "test_ai_arena",
    "layout": [
        "WWWWWWWWWWWWWWWWWWWW",
        "W..................W",
        "W..................W",
        "W...E..............W",
        "W..................W",
        "W.......WWWW.......W",
        "W.......W..W.......W",
        "W.......W..W.......W",
        "W.......W..W.......W",
        "W..................W",
        "W..................W",
        "W...P..........P...W",
        "W..................W",
        "W..................W",
        "W..................W",
        "W..................W",
        "W..................W",
        "W..................W",
        "W..................W",
        "WWWWWWWWWWWWWWWWWWWW"
    ],
    "legend": {
        "W": "Wall",
        ".": "Floor",
        "E": "Entity",
        "P": "Pillar"
    }
}