{
    "level_id": "test_arena_combined",
    "width": 40,
    "height": 20,
    "legend": {
        "#": "Wall",
        ".": "Floor",
        "S": "Start",
        "E": "Entity",
        "K": "Key",
        "D": "Debris",
        "O": "Pillar",
        "L": "Locked Door",
        "X": "Exit"
    },
    "layout": [
        "########################################",
        "#..................#O.O.O.O.O.O.O.O.O.#",
        "#..................#...................#",
        "#..................#O.O.O.O.O.O.O.O.O.#",
        "#..................#...................#",
        "#.......S..........#O.O.O.O.O.O.O.O.O.#",
        "#..................#...................#",
        "#..................#O.O.O.O.O.O.O.O.O.#",
        "#..................#...................#",
        "#..................#O.O.O.O.O.O.O.O.O.#",
        "#..................#...................#",
        "#..................#O.O.O.O.O.O.O.O.O.#",
        "#..................#...................#",
        "#..................#O.O.O.E.O.O.O.O.O.#",
        "#..........E.......#...................#",
        "#..................#O.O.O.O.O.O.O.O.O.#",
        "#..................#...................#",
        "#..................#O.O.O.O.O.O.O.O.O.#",
        "########################################",
        "########################################"
    ]
}